00's Club Hits=00sclubhits
Ambient=ambient
Atmospheric Breaks=atmosphericbreaks
Bass & Jackin' House=bassnjackinhouse
Bassline=bassline
Big Beat=bigbeat
Big Room House=bigroomhouse
Breaks=breaks
Chill & Tropical House=chillntropicalhouse
Chillhop=chillhop
Chillout Dreams=chilloutdreams
Chillout=chillout
Chillstep=chillstep
Chiptunes=chiptunes
Classic Eurodance=classiceurodance
Classic Eurodisco=classiceurodisco
Classic Trance=classictrance
Classic Vocal Trance=classicvocaltrance
Club Dubstep=clubdubstep
Club Sounds=clubsounds
Dark DnB=darkdnb
Dark PsyTrance=darkpsytrance
Deep House=deephouse
Deep Nu-Disco=deepnudisco
Deep Tech=deeptech
Detroit House & Techno=detroithousentechno
Disco House=discohouse
DJ Mixes=djmixes
Downtempo Lounge=downtempolounge
Drum 'n Bass=drumandbass
Drumstep=drumstep
Dub Techno=dubtechno
Dub=dub
Dubstep=dubstep
EBM=ebm
EcLectronica=eclectronica
Electro House=electrohouse
Electro Swing=electroswing
Electronic Pioneers=electronicpioneers
Electronics=electronics
Electropop=electropop
Epic Trance=epictrance
Eurodance=eurodance
Funky House=funkyhouse
Future Beats=futurebeats
Future Garage=futuregarage
Future Synthpop=futuresynthpop
Gabber=gabber
Glitch Hop=glitchhop
Goa-Psy Trance=goapsy
Hands Up=handsup
Hard Dance=harddance
Hard Techno=hardtechno
Hardcore=hardcore
Hardstyle=hardstyle
House=house
IDM=idm
Indie Beats=indiebeats
Indie Dance=indiedance
Jazz House=jazzhouse
Jungle=jungle
Liquid House=liquidhouse
Liquid DnB=liquiddnb
Liquid Dubstep=liquiddubstep
Liquid Trap=liquidtrap
Lounge=lounge
Mainstage=mainstage
Melodic Progressive=melodicprogressive
Minimal=minimal
Moombahton=moombahton
Nightcore=nightcore
Nu Disco=nudisco
Oldschool Acid=oldschoolacid
Oldschool Electronica=oldschoolelectronica
Oldschool House=oldschoolhouse
Oldschool Rave=oldschoolrave
Progressive Psy=progressivepsy
Progressive=progressive
Psybient=psybient
PsyChill=psychill
Russian Club Hits=russianclubhits
Soulful House=soulfulhouse
Space Dreams=spacedreams
Tech House=techhouse
Techno=techno
Trance=trance
Trap=trap
Tribal House=tribalhouse
UMF Radio=umfradio
Underground Techno=undergroundtechno
Vocal Chillout=vocalchillout
Vocal Lounge=vocallounge
Vocal Trance=vocaltrance